0 0 0 0 M
0 0 0 M 0
0 0 M 0 0
0 M 0 0 0
M 0 0 0 0